30 30
==============================
/............................/
=............................=
=............................=
=............................=
=........==========..........=
=............................=
=............................=
=............................=
=............................=
=........==========..........=
=............................=
=............................=
=............................=
=............................=
=........==========..........=
=............................=
=............................=
=............................=
=............................=
=........==========..........=
=............................=
=............................=
=............................=
=............................=
=........==========..........=
=............................=
=............................=
/............................/
==============================
